{
  "firstRoom": [
    ["0","0","0","0","0","0","0","0","0","0","0","0","0","0","0","0","0","0","0","0","0","0","0","0","0","0"],
    ["0","0","0","0","0","0","0","0","0","0","0","0","0","0","0","0","0","0","0","0","0","0","0","0","0","0"],
    ["0","0","0","0","0","0","0","0","0","0","0","0","0","0","0","0","0","0","0","0","0","0","0","0","0","0"],
    ["0","0","0","0","0","0","x","0","0","0","0","0","0","0","0","0","0","0","0","0","0","0","0","0","0","0"],
    ["0","0","0","0","0","0","x","0","0","0","0","0","0","0","0","0","0","0","0","0","0","0","0","0","0","0"],
    ["0","0","0","0","0","0","x","0","0","0","0","0","0","0","0","0","0","0","0","0","0","0","0","0","0","0"],
    ["0","0","0","0","0","0","x","0","0","0","0","0","0","0","0","0","0","0","0","0","0","0","0","0","0","0"],
    ["0","0","0","0","0","0","x","0","0","0","0","0","0","0","0","0","0","0","0","0","0","0","0","0","0","0"],
    ["0","0","0","0","0","0","x","0","0","0","0","0","0","0","0","0","0","0","0","0","0","0","0","0","0","0"],
    ["0","0","0","0","0","0","x","0","0","0","0","0","0","0","0","0","0","0","0","0","0","0","0","0","0","0"],
    ["0","0","0","0","0","0","x","0","0","0","0","0","0","0","0","0","0","0","0","0","0","0","0","0","0","0"],
    ["0","0","0","0","0","0","x","0","0","0","0","0","0","0","0","0","0","0","0","0","0","0","0","0","0","0"],
    ["0","0","0","0","0","0","0","0","0","0","0","0","0","0","0","0","0","0","0","0","0","0","0","0","0","0"],
    ["0","0","0","0","0","0","0","0","0","0","0","0","0","0","0","0","0","0","0","0","0","0","0","0","0","0"],
    ["0","0","0","0","0","0","0","0","0","0","0","0","0","0","0","0","0","0","0","0","0","0","0","0","0","0"],
    ["0","0","0","0","0","0","0","0","0","0","0","0","0","0","0","0","0","0","0","0","0","0","0","0","0","0"]
  ],
  "room1": [
    ["0","0","0","0","0","0","0","0","0","0","0","0","0","0","0","0","0","0","0","0","0","0","0","0","0","0"],
    ["0","0","0","0","0","0","0","0","0","0","0","0","0","0","0","0","0","0","0","0","0","0","0","0","0","0"],
    ["0","0","0","0","0","0","0","0","0","0","0","0","0","0","0","0","0","0","0","0","0","0","0","0","0","0"],
    ["0","0","0","0","0","0","x","0","d","0","0","0","0","0","0","0","0","0","0","0","0","0","0","0","0","0"],
    ["0","0","0","0","0","0","x","0","0","0","0","0","0","0","0","0","0","0","0","0","0","0","0","0","0","0"],
    ["0","0","k","0","0","0","x","0","0","0","0","0","0","0","0","0","0","0","0","0","0","0","0","0","0","0"],
    ["0","0","0","0","0","0","x","0","0","0","0","0","0","0","0","0","0","0","0","0","0","0","0","0","0","0"],
    ["0","0","0","0","0","0","x","0","0","0","0","0","0","0","0","0","0","0","0","0","0","0","0","0","0","0"],
    ["0","0","0","0","0","0","x","0","0","0","0","0","0","0","0","0","0","0","0","0","0","0","0","0","0","0"],
    ["0","0","0","0","0","0","x","0","0","0","0","0","0","0","0","0","0","0","0","0","0","0","0","0","0","0"],
    ["0","0","0","0","0","0","x","0","0","0","0","0","0","0","0","0","0","0","0","0","0","0","0","0","0","0"],
    ["0","0","0","0","0","0","x","0","b","0","0","0","0","0","0","0","0","0","0","0","0","0","0","0","0","0"],
    ["0","0","0","0","0","0","0","0","0","0","0","0","0","0","0","0","0","0","0","0","0","0","0","0","0","0"],
    ["0","0","0","0","0","0","0","0","0","0","0","0","0","0","0","0","0","0","0","0","0","0","0","0","0","0"],
    ["0","0","0","0","0","0","0","0","0","0","0","0","0","0","0","0","0","0","0","0","0","0","0","0","0","0"],
    ["0","0","0","0","0","0","0","0","0","0","0","0","0","0","0","0","0","0","0","0","0","0","0","0","0","0"]
  ],
  "room2": [
    ["0","0","0","0","0","0","0","0","0","0","0","0","0","0","0","0","0","0","0","0","0","0","0","0","0","0"],
    ["0","0","0","0","0","0","0","0","0","0","0","0","0","0","0","0","0","0","0","0","0","0","0","0","0","0"],
    ["0","0","0","0","0","0","0","0","0","0","0","0","0","0","0","0","0","0","0","0","0","0","0","0","0","0"],
    ["0","0","0","0","0","0","0","0","0","0","0","0","0","0","0","0","0","0","0","0","0","0","0","0","0","0"],
    ["0","0","0","0","0","0","0","0","0","0","0","0","0","0","0","0","0","0","0","0","0","0","0","0","0","0"],
    ["0","0","0","0","0","0","0","0","0","0","0","0","0","0","0","0","0","0","0","0","0","0","0","0","0","0"],
    ["0","0","0","0","0","0","0","0","0","0","0","0","0","0","0","0","0","0","0","0","0","0","0","0","0","0"],
    ["0","0","0","0","0","0","0","0","0","0","0","0","0","0","0","0","0","0","0","0","0","0","0","0","0","0"],
    ["0","0","0","0","0","0","0","0","0","0","0","0","0","0","0","0","0","0","0","0","0","0","0","0","0","0"],
    ["0","0","0","0","0","0","0","0","0","0","0","0","0","0","0","0","0","0","0","0","0","0","0","0","0","0"],
    ["0","0","0","0","0","0","0","0","0","0","0","0","0","0","0","0","0","0","0","0","0","0","0","0","0","0"],
    ["0","0","0","0","0","0","0","0","0","0","0","0","0","0","0","0","0","0","0","0","0","0","0","0","0","0"],
    ["0","0","0","0","0","0","0","0","0","0","0","0","0","0","0","0","0","0","0","0","0","0","0","0","0","0"],
    ["0","0","0","0","0","0","0","0","0","0","0","0","0","0","0","0","0","0","0","0","0","0","0","0","0","0"],
    ["0","0","0","0","0","0","0","0","0","0","0","0","0","0","0","0","0","0","0","0","0","0","0","0","0","0"],
    ["0","0","0","0","0","0","0","0","0","0","0","0","0","0","0","0","0","0","0","0","0","0","0","0","0","0"]
  ],
  "room3": [
    ["0","0","0","0","0","0","0","0","0","0","0","0","0","0","0","0","0","0","0","0","0","0","0","0","0","0"],
    ["0","0","0","0","0","0","0","0","0","0","0","0","0","0","0","0","0","0","0","0","0","0","0","0","0","0"],
    ["0","0","0","0","0","0","0","0","x","x","x","x","x","x","0","0","0","0","0","0","0","0","0","0","0","0"],
    ["0","0","0","0","0","0","0","0","0","0","0","0","0","0","0","0","0","0","0","0","0","0","0","0","0","0"],
    ["0","0","0","0","0","0","0","0","0","0","0","0","0","0","0","0","0","0","0","0","0","0","0","0","0","0"],
    ["0","0","0","0","0","0","0","0","0","0","0","0","0","0","0","0","0","0","0","0","0","0","0","0","0","0"],
    ["0","0","0","0","0","0","0","0","0","d","0","0","d","0","0","0","0","0","0","0","0","0","0","0","0","0"],
    ["0","0","0","0","0","0","0","0","0","0","0","0","0","0","0","0","0","0","0","0","0","0","0","0","0","0"],
    ["0","0","0","0","0","0","0","0","0","0","0","0","0","0","0","0","0","0","0","0","0","0","0","0","0","0"],
    ["0","0","0","0","0","0","0","0","0","d","0","0","d","0","0","0","0","0","0","0","0","0","0","0","0","0"],
    ["0","0","0","0","0","0","0","0","0","0","0","0","0","0","0","0","0","0","0","0","0","0","0","0","0","0"],
    ["0","0","0","0","0","0","0","0","0","0","0","0","0","0","0","0","0","0","0","0","0","0","0","0","0","0"],
    ["0","0","0","0","0","0","0","0","x","x","x","x","x","x","0","0","0","0","0","0","0","0","0","0","0","0"],
    ["0","0","0","0","0","0","0","0","0","0","0","0","0","0","0","0","0","0","0","0","0","0","0","0","0","0"],
    ["0","0","0","0","0","0","0","0","0","0","0","0","0","0","0","0","0","0","0","0","0","0","0","0","0","0"],
    ["0","0","0","0","0","0","0","0","0","0","0","0","0","0","0","0","0","0","0","0","0","0","0","0","0","0"]
  ],
  "room4": [
    ["0","0","0","0","0","0","0","0","0","0","0","0","0","0","0","0","0","0","0","0","0","0","0","0","0","0"],
    ["0","0","0","0","0","0","0","0","0","0","0","0","0","0","0","0","0","0","0","0","0","0","0","0","0","0"],
    ["0","0","x","x","x","x","x","x","x","x","x","x","x","x","x","x","x","x","x","x","x","x","x","x","0","0"],
    ["0","0","x","0","0","0","0","0","0","0","0","0","0","0","0","0","0","0","0","0","0","0","0","x","0","0"],
    ["0","0","x","0","0","b","0","0","0","0","0","0","0","0","0","0","0","0","0","0","b","0","0","x","0","0"],
    ["0","0","x","0","0","0","0","0","0","0","0","0","0","0","0","0","0","0","0","0","0","0","0","x","0","0"],
    ["0","0","x","0","0","0","0","0","0","0","0","0","0","0","0","0","0","0","0","0","0","0","0","x","0","0"],
    ["0","0","x","0","0","b","0","0","0","0","0","0","0","0","0","0","0","0","0","0","b","0","0","x","0","0"],
    ["0","0","x","0","0","0","0","0","0","0","0","0","0","0","0","0","0","0","0","0","0","0","0","x","0","0"],
    ["0","0","x","0","0","0","0","0","0","0","0","0","0","0","0","0","0","0","0","0","0","0","0","x","0","0"],
    ["0","0","x","0","0","0","0","0","0","0","0","0","0","0","0","0","0","0","0","0","0","0","0","x","0","0"],
    ["0","0","x","0","0","b","0","0","0","0","0","0","0","0","0","0","0","0","0","0","b","0","0","x","0","0"],
    ["0","0","x","0","0","0","0","0","0","0","0","0","0","0","0","0","0","0","0","0","0","0","0","x","0","0"],
    ["0","0","x","x","x","x","x","x","x","x","x","x","x","x","x","0","0","x","x","x","x","x","x","x","0","0"],
    ["0","0","0","0","0","0","0","0","0","0","0","0","0","0","0","0","0","0","0","0","0","0","0","0","0","0"],
    ["0","0","0","0","0","0","0","0","0","0","0","0","0","0","0","0","0","0","0","0","0","0","0","0","0","0"]
  ],
  "room5": [
    ["0","0","0","0","0","0","0","0","0","0","0","0","0","0","0","0","0","0","0","0","0","0","0","0","0","0"],
    ["0","0","0","0","0","0","0","0","0","0","0","0","0","0","0","0","0","0","0","0","0","0","0","0","0","0"],
    ["0","0","0","0","0","0","0","0","0","0","0","d","0","0","0","0","0","0","0","0","0","0","0","0","0","0"],
    ["0","0","0","0","0","0","0","0","0","0","0","0","0","0","0","0","0","0","0","0","0","0","0","0","0","0"],
    ["0","0","0","0","0","0","0","0","0","0","0","0","0","0","0","0","0","0","0","0","0","0","0","0","0","0"],
    ["0","0","0","0","0","0","0","0","0","0","0","0","0","0","0","0","0","0","0","0","0","0","0","0","0","0"],
    ["0","0","0","0","0","0","0","0","0","0","0","0","0","0","0","0","0","0","0","0","0","0","0","0","0","0"],
    ["0","0","0","0","0","0","0","0","0","0","0","0","0","0","0","0","0","0","0","0","0","0","0","0","0","0"],
    ["0","0","0","0","0","0","b","0","0","0","0","0","0","0","0","0","0","0","d","0","0","0","0","0","0","0"],
    ["0","0","0","0","0","0","0","0","0","0","0","0","0","0","0","0","0","0","0","0","0","0","0","0","0","0"],
    ["0","0","0","0","0","0","0","0","0","0","0","0","b","0","0","0","0","0","0","0","0","0","0","0","0","0"],
    ["0","0","0","0","0","0","0","0","0","0","0","0","0","0","0","0","0","0","0","0","0","0","0","0","0","0"],
    ["0","0","0","0","0","0","0","0","0","0","0","0","0","0","0","0","0","0","0","0","0","0","0","0","0","0"],
    ["0","0","0","0","0","0","0","0","0","0","0","0","0","0","0","0","0","0","0","0","0","0","0","0","0","0"],
    ["0","0","0","0","0","0","0","0","0","0","0","0","0","0","0","0","0","0","0","0","0","0","0","0","0","0"],
    ["0","0","0","0","0","0","0","0","0","0","0","0","0","0","0","0","0","0","0","0","0","0","0","0","0","0"]
  ],
  "room6": [
    ["0","0","0","0","0","0","0","0","0","0","0","0","0","0","0","0","0","0","0","0","0","0","0","0","0","0"],
    ["0","0","0","0","0","0","0","0","0","0","0","0","0","0","0","0","0","0","0","0","0","0","0","0","0","0"],
    ["0","0","0","0","x","0","0","0","0","0","0","0","0","0","0","0","0","0","0","0","0","0","0","0","0","0"],
    ["0","0","0","0","0","0","0","0","0","0","0","0","0","0","0","0","0","0","0","0","0","0","0","0","0","0"],
    ["0","0","0","0","0","0","0","0","0","0","0","0","0","0","0","0","0","0","0","0","0","0","0","0","0","0"],
    ["0","0","0","0","0","0","0","0","0","0","0","0","0","0","0","0","0","0","0","0","0","0","0","0","0","0"],
    ["0","0","0","0","0","0","0","0","0","0","0","0","0","0","0","0","0","0","0","x","0","0","0","0","0","0"],
    ["0","0","0","0","0","0","0","0","0","0","0","x","0","0","0","0","0","0","0","0","0","0","0","0","0","0"],
    ["0","0","0","0","0","0","0","0","0","0","0","0","0","0","0","0","0","0","0","0","0","0","0","0","0","0"],
    ["0","0","0","0","0","0","0","0","0","0","0","0","0","0","0","0","0","0","0","0","0","0","0","0","0","0"],
    ["0","0","0","0","x","0","x","0","0","0","0","0","0","0","0","0","0","0","0","0","0","0","0","0","0","0"],
    ["0","0","0","0","0","0","0","0","0","0","0","0","0","0","0","0","0","0","0","0","0","0","0","0","0","0"],
    ["0","0","0","0","0","0","0","0","0","x","x","x","0","0","0","0","0","0","0","x","0","0","0","0","0","0"],
    ["0","0","0","0","0","0","0","0","0","0","0","0","0","0","0","0","0","0","0","0","0","0","0","0","0","0"],
    ["0","0","0","0","0","0","0","0","0","0","0","0","0","0","0","0","0","0","0","0","0","0","0","0","0","0"],
    ["0","0","0","0","0","0","0","0","0","0","0","0","0","0","0","0","0","0","0","0","0","0","0","0","0","0"]
  ],
  "room7": [
    ["0","0","0","0","0","0","0","0","0","0","0","0","0","0","0","0","0","0","0","0","0","0","0","0","0","0"],
    ["0","0","0","0","0","0","0","0","0","0","0","0","0","0","0","0","0","0","0","0","0","0","0","0","0","0"],
    ["0","0","0","0","0","0","0","0","0","0","0","0","0","0","0","0","0","0","0","0","0","0","0","0","0","0"],
    ["0","0","0","0","0","0","0","0","0","0","0","0","0","x","0","0","0","0","0","0","0","0","0","0","0","0"],
    ["0","0","0","0","0","0","0","0","0","0","0","0","0","x","0","0","0","0","0","0","0","0","0","0","0","0"],
    ["0","0","0","0","0","0","0","0","0","0","0","0","0","x","0","0","0","0","0","0","0","0","0","0","0","0"],
    ["0","0","0","0","0","0","0","0","0","0","0","0","0","x","0","0","0","0","0","0","0","0","0","0","0","0"],
    ["0","0","0","0","0","0","0","0","k","0","0","0","0","x","0","0","0","k","0","0","0","0","0","0","0","0"],
    ["0","0","0","0","0","0","0","0","0","0","0","0","0","x","0","0","0","0","0","0","0","0","0","0","0","0"],
    ["0","0","0","0","0","0","0","0","0","0","0","0","0","x","0","0","0","0","0","0","0","0","0","0","0","0"],
    ["0","0","0","0","0","0","0","0","0","0","0","0","0","x","0","0","0","0","0","0","0","0","0","0","0","0"],
    ["0","0","0","0","0","0","0","0","0","0","0","0","0","x","0","0","0","0","0","0","0","0","0","0","0","0"],
    ["0","0","0","0","0","0","0","0","0","0","0","0","0","x","0","0","0","0","0","0","0","0","0","0","0","0"],
    ["0","0","0","0","0","0","0","0","0","0","0","0","0","x","0","0","0","0","0","0","0","0","0","0","0","0"],
    ["0","0","0","0","0","0","0","0","0","0","0","0","0","0","0","0","0","0","0","0","0","0","0","0","0","0"],
    ["0","0","0","0","0","0","0","0","0","0","0","0","0","0","0","0","0","0","0","0","0","0","0","0","0","0"]
  ]
}