{
  "room1": [
    ["x","0","0","0","0","0","0","0","0","0","0","0","0","0","0","0","0","0","0","0","0","0","0","0","0","x"],
    ["0","0","0","x","0","0","0","x","0","x","0","x","0","0","0","0","0","0","0","0","0","0","0","0","0","0"],
    ["0","0","0","x","0","0","0","x","0","x","0","x","0","0","0","0","0","0","0","0","0","0","0","0","0","0"],
    ["0","0","0","x","0","0","0","x","0","x","0","x","0","0","0","0","0","0","0","0","0","0","0","0","0","0"],
    ["0","0","0","x","x","x","0","x","x","x","0","x","x","x","0","0","0","0","0","0","0","0","0","0","0","0"],
    ["0","0","0","0","0","0","0","0","0","0","0","0","0","0","0","0","0","0","0","0","0","0","0","0","0","0"],
    ["0","0","0","0","0","0","0","0","0","0","0","0","0","0","0","0","0","0","0","0","0","0","0","0","0","0"],
    ["0","0","0","0","0","0","0","0","0","0","0","0","0","0","0","0","0","0","0","0","0","0","0","0","0","0"],
    ["0","0","0","0","0","0","0","0","0","k","0","0","0","0","0","0","0","0","0","0","0","0","0","0","0","0"],
    ["0","0","0","0","0","0","0","0","0","0","0","0","0","0","0","0","0","0","0","0","0","0","0","0","0","0"],
    ["0","0","0","0","0","0","0","0","x","x","x","x","0","0","0","0","0","0","0","0","0","0","0","0","0","0"],
    ["0","0","0","0","0","0","0","0","0","0","0","x","0","0","0","0","0","0","0","0","0","0","0","0","0","0"],
    ["0","0","0","0","0","0","0","0","0","0","0","x","0","0","0","0","0","0","0","0","0","0","0","0","0","0"],
    ["0","0","0","0","0","0","0","0","0","0","0","x","x","x","0","0","0","0","0","0","0","0","0","0","0","0"],
    ["0","0","0","0","0","0","0","0","0","0","0","0","0","0","0","0","0","0","0","0","0","0","0","0","0","0"],
    ["x","0","0","0","0","0","0","0","0","0","0","0","0","0","0","0","0","0","0","0","0","0","0","0","0","x"]
  ],
  "room2": [
    ["0","0","0","0","0","0","0","0","0","0","0","0","0","0","0","0","0","0","0","0","0","0","0","0","0","0"],
    ["0","0","0","0","0","0","0","0","0","0","0","0","0","0","0","0","0","0","0","0","0","0","0","0","0","0"],
    ["0","0","0","0","0","0","0","0","0","0","0","0","0","0","0","0","0","0","0","0","0","0","0","0","0","0"],
    ["0","0","0","0","0","0","0","0","0","0","0","0","0","0","0","0","0","0","0","0","0","0","0","0","0","0"],
    ["0","0","0","0","0","0","0","0","0","0","0","0","0","0","0","0","0","0","0","0","0","0","0","0","0","0"],
    ["0","0","0","0","0","0","0","0","0","0","0","0","0","0","0","0","0","0","0","0","0","0","0","0","0","0"],
    ["0","0","0","0","0","0","0","0","0","0","0","0","0","0","0","0","0","0","0","0","0","0","0","0","0","0"],
    ["0","0","0","0","0","0","0","0","0","0","0","0","0","0","0","0","0","0","0","0","0","0","0","0","0","0"],
    ["0","0","0","0","0","0","0","0","0","0","0","0","0","0","0","0","0","0","0","0","0","0","0","0","0","0"],
    ["0","0","0","0","0","0","0","0","0","0","0","0","0","0","0","0","0","0","0","0","0","0","0","0","0","0"],
    ["0","0","0","0","0","0","0","0","0","0","0","0","0","0","0","0","0","0","0","0","0","0","0","0","0","0"],
    ["0","0","0","0","0","0","0","0","0","0","0","0","0","0","0","0","0","0","0","0","0","0","0","0","0","0"],
    ["0","0","0","0","0","0","0","0","0","0","0","0","0","0","0","0","0","0","0","0","0","0","0","0","0","0"],
    ["0","0","0","0","0","0","0","0","0","0","0","0","0","0","0","0","0","0","0","0","0","0","0","0","0","0"],
    ["0","0","0","0","0","0","0","0","0","0","0","0","0","0","0","0","0","0","0","0","0","0","0","0","0","0"],
    ["0","0","0","0","0","0","0","0","0","0","0","0","0","0","0","0","0","0","0","0","0","0","0","0","0","0"]
  ]
}