{
  "room1": [
    ["x","0","0","0","0","0","0","0","0","0","0","0","0","0","0","0","0","0","0","0","0","0","0","0","0","x"],
    ["0","0","0","x","x","x","0","x","x","x","0","x","0","x","0","0","x","0","0","0","0","0","0","0","0","0"],
    ["0","0","0","x","0","0","0","x","0","x","0","x","0","x","0","x","0","0","0","0","0","0","0","0","0","0"],
    ["0","0","d","x","x","0","0","x","x","0","0","x","0","x","x","0","0","0","0","0","0","0","0","0","0","0"],
    ["0","0","d","x","0","0","0","x","0","x","0","x","0","x","0","x","0","0","0","0","0","0","0","0","0","0"],
    ["0","0","b","x","x","x","0","x","0","x","0","x","0","x","0","0","x","0","0","0","0","0","0","0","0","0"],
    ["0","0","d","0","0","0","0","0","0","0","0","0","0","0","0","0","0","0","0","0","0","0","0","0","0","0"],
    ["0","0","d","0","0","0","0","0","0","0","0","0","0","0","0","0","0","0","0","0","0","0","0","0","0","0"],
    ["0","0","b","0","0","0","0","0","0","0","0","0","0","0","0","0","0","0","0","0","0","0","0","0","0","0"],
    ["0","0","d","0","0","0","0","0","0","0","0","0","0","0","0","0","0","0","0","0","0","0","0","0","0","0"],
    ["0","0","b","0","0","0","0","0","x","x","x","x","0","0","0","0","0","0","0","0","0","0","0","0","0","0"],
    ["0","0","b","0","0","0","0","0","0","0","0","x","0","0","0","0","0","0","0","0","0","0","0","0","0","0"],
    ["0","0","d","0","0","0","0","0","0","0","0","x","0","0","0","0","0","0","0","0","0","0","0","0","0","0"],
    ["0","0","0","0","0","0","0","0","0","0","0","x","x","x","0","0","0","0","0","0","0","0","0","0","0","0"],
    ["0","0","0","0","0","0","0","0","0","0","0","0","0","0","0","0","0","0","0","0","0","0","0","0","0","0"],
    ["x","0","0","0","0","0","0","0","0","0","0","0","0","0","0","0","0","0","0","0","0","0","0","0","0","x"]
  ],
  "room2": [
    ["0","0","0","0","0","0","0","0","0","0","0","0","0","0","0","0","0","0","0","0","0","0","0","0","0","0"],
    ["0","0","0","0","0","0","0","0","0","0","0","0","0","0","0","0","0","0","0","0","0","0","0","0","0","0"],
    ["0","0","0","0","0","0","0","0","0","0","0","0","0","0","0","0","0","0","0","0","0","0","0","0","0","0"],
    ["0","0","0","0","0","0","0","0","0","0","0","0","0","0","0","0","0","0","0","0","0","0","0","0","0","0"],
    ["0","0","0","0","0","0","0","0","0","0","0","0","0","0","0","0","0","0","0","0","0","0","0","0","0","0"],
    ["0","0","0","0","0","0","0","0","0","0","0","0","0","0","0","0","0","0","0","0","0","0","0","0","0","0"],
    ["0","0","0","0","0","0","0","0","0","0","0","0","0","0","0","0","0","0","0","0","0","0","0","0","0","0"],
    ["0","0","0","0","0","0","0","0","0","0","0","0","0","0","0","0","0","0","0","0","0","0","0","0","0","0"],
    ["0","0","0","0","0","0","0","0","0","0","0","0","0","0","0","0","0","0","0","0","0","0","0","0","0","0"],
    ["0","0","0","0","0","0","0","0","0","0","0","0","0","0","0","0","0","0","0","0","0","0","0","0","0","0"],
    ["0","0","0","0","0","0","0","0","0","0","0","0","0","0","0","0","0","0","0","0","0","0","0","0","0","0"],
    ["0","0","0","0","0","0","0","0","0","0","0","0","0","0","0","0","0","0","0","0","0","0","0","0","0","0"],
    ["0","0","0","0","0","0","0","0","0","0","0","0","0","0","0","0","0","0","0","0","0","0","0","0","0","0"],
    ["0","0","0","0","0","0","0","0","0","0","0","0","0","0","0","0","0","0","0","0","0","0","0","0","0","0"],
    ["0","0","0","0","0","0","0","0","0","0","0","0","0","0","0","0","0","0","0","0","0","0","0","0","0","0"],
    ["0","0","0","0","0","0","0","0","0","0","0","0","0","0","0","0","0","0","0","0","0","0","0","0","0","0"]
  ]
}