{
  "firstRoom": [
    ["0","0","0","0","0","0","0","0","0","0","0","0","0","0","0","0","0","0","0","0","0","0","0","0","0","0"],
    ["0","0","0","0","0","0","0","0","0","0","0","0","0","0","0","0","0","0","0","0","0","0","0","0","0","0"],
    ["0","0","0","0","0","0","0","0","0","0","0","0","0","0","0","0","0","0","0","0","0","0","0","0","0","0"],
    ["0","0","0","0","0","0","x","0","0","0","0","0","0","0","0","0","0","0","0","0","0","0","0","0","0","0"],
    ["0","0","0","0","0","0","x","0","0","0","0","0","0","0","0","0","0","0","0","0","0","0","0","0","0","0"],
    ["0","0","0","0","0","0","x","0","0","0","0","0","0","0","0","0","0","0","0","0","0","0","0","0","0","0"],
    ["0","0","0","0","0","0","x","0","0","0","0","0","0","0","0","0","0","0","0","0","0","0","0","0","0","0"],
    ["0","0","0","0","0","0","x","0","0","0","0","0","0","0","0","0","0","0","0","0","0","0","0","0","0","0"],
    ["0","0","0","0","0","0","x","0","0","0","0","0","0","0","0","0","0","0","0","0","0","0","0","0","0","0"],
    ["0","0","0","0","0","0","x","0","0","0","0","0","0","0","0","0","0","0","0","0","0","0","0","0","0","0"],
    ["0","0","0","0","0","0","x","0","0","0","0","0","0","0","0","0","0","0","0","0","0","0","0","0","0","0"],
    ["0","0","0","0","0","0","x","0","0","0","0","0","0","0","0","0","0","0","0","0","0","0","0","0","0","0"],
    ["0","0","0","0","0","0","0","0","0","0","0","0","0","0","0","0","0","0","0","0","0","0","0","0","0","0"],
    ["0","0","0","0","0","0","0","0","0","0","0","0","0","0","0","0","0","0","0","0","0","0","0","0","0","0"],
    ["0","0","0","0","0","0","0","0","0","0","0","0","0","0","0","0","0","0","0","0","0","0","0","0","0","0"],
    ["0","0","0","0","0","0","0","0","0","0","0","0","0","0","0","0","0","0","0","0","0","0","0","0","0","0"]
  ],
  "room1": [
    ["0","0","0","0","0","0","0","0","0","0","0","0","0","0","0","0","0","0","0","0","0","0","0","0","0","0"],
    ["0","0","0","0","0","0","0","0","0","0","0","0","0","0","0","0","0","0","0","0","0","0","0","0","0","0"],
    ["0","0","0","0","0","0","0","0","0","0","0","0","0","0","0","0","0","0","0","0","0","0","0","0","0","0"],
    ["0","0","0","0","0","0","x","0","d","0","0","0","0","0","0","0","0","0","0","0","0","0","0","0","0","0"],
    ["0","0","0","0","0","0","x","0","0","0","0","0","0","0","0","0","0","0","0","0","0","0","0","0","0","0"],
    ["0","0","k","0","0","0","x","0","0","0","0","0","0","0","0","0","0","0","0","0","0","0","0","0","0","0"],
    ["0","0","0","0","0","0","x","0","0","0","0","0","0","0","0","0","0","0","0","0","0","0","0","0","0","0"],
    ["0","0","0","0","0","0","x","0","0","0","0","0","0","0","0","0","0","0","0","0","0","0","0","0","0","0"],
    ["0","0","0","0","0","0","x","0","0","0","0","0","0","0","0","0","0","0","0","0","0","0","0","0","0","0"],
    ["0","0","0","0","0","0","x","0","0","0","0","0","0","0","0","0","0","0","0","0","0","0","0","0","0","0"],
    ["0","0","0","0","0","0","x","0","0","0","0","0","0","0","0","0","0","0","0","0","0","0","0","0","0","0"],
    ["0","0","0","0","0","0","x","0","b","0","0","0","0","0","0","0","0","0","0","0","0","0","0","0","0","0"],
    ["0","0","0","0","0","0","0","0","0","0","0","0","0","0","0","0","0","0","0","0","0","0","0","0","0","0"],
    ["0","0","0","0","0","0","0","0","0","0","0","0","0","0","0","0","0","0","0","0","0","0","0","0","0","0"],
    ["0","0","0","0","0","0","0","0","0","0","0","0","0","0","0","0","0","0","0","0","0","0","0","0","0","0"],
    ["0","0","0","0","0","0","0","0","0","0","0","0","0","0","0","0","0","0","0","0","0","0","0","0","0","0"]
  ],
  "room2": [
    ["0","0","0","0","0","0","0","0","0","0","0","0","0","0","0","0","0","0","0","0","0","0","0","0","0","0"],
    ["0","0","0","0","0","0","0","0","0","0","0","0","0","0","0","0","0","0","0","0","0","0","0","0","0","0"],
    ["0","0","0","0","0","0","0","0","0","0","0","0","0","0","0","0","0","0","0","0","0","0","0","0","0","0"],
    ["0","0","0","0","0","0","0","0","0","0","0","0","0","0","0","0","0","0","0","0","0","0","0","0","0","0"],
    ["0","0","0","0","0","0","0","0","0","0","0","0","0","0","0","0","0","0","0","0","0","0","0","0","0","0"],
    ["0","0","0","0","0","0","0","0","0","0","0","0","0","0","0","0","0","0","0","0","0","0","0","0","0","0"],
    ["0","0","0","0","0","0","0","0","0","0","0","0","0","0","0","0","0","0","0","0","0","0","0","0","0","0"],
    ["0","0","0","0","0","0","0","0","0","0","0","0","0","0","0","0","0","0","0","0","0","0","0","0","0","0"],
    ["0","0","0","0","0","0","0","0","0","0","0","0","0","0","0","0","0","0","0","0","0","0","0","0","0","0"],
    ["0","0","0","0","0","0","0","0","0","0","0","0","0","0","0","0","0","0","0","0","0","0","0","0","0","0"],
    ["0","0","0","0","0","0","0","0","0","0","0","0","0","0","0","0","0","0","0","0","0","0","0","0","0","0"],
    ["0","0","0","0","0","0","0","0","0","0","0","0","0","0","0","0","0","0","0","0","0","0","0","0","0","0"],
    ["0","0","0","0","0","0","0","0","0","0","0","0","0","0","0","0","0","0","0","0","0","0","0","0","0","0"],
    ["0","0","0","0","0","0","0","0","0","0","0","0","0","0","0","0","0","0","0","0","0","0","0","0","0","0"],
    ["0","0","0","0","0","0","0","0","0","0","0","0","0","0","0","0","0","0","0","0","0","0","0","0","0","0"],
    ["0","0","0","0","0","0","0","0","0","0","0","0","0","0","0","0","0","0","0","0","0","0","0","0","0","0"]
  ]
}