{
  "room1": [
    ["0","0","0","0","0","0","0","0","0","0","0","0","0","0","0","0","0","0","0","0","0","0","0","0","0","0"],
    ["0","0","0","x","0","0","0","x","0","x","0","x","0","0","0","0","0","0","0","0","0","0","0","0","0","0"],
    ["0","0","0","x","0","0","0","x","0","x","0","x","0","0","0","0","0","0","0","0","0","0","0","0","0","0"],
    ["0","0","0","x","0","0","0","x","0","x","0","x","0","0","0","0","0","0","0","0","0","0","0","0","0","0"],
    ["0","0","0","x","x","x","0","x","x","x","0","x","x","x","0","0","0","0","0","0","0","0","0","0","0","0"],
    ["0","0","0","0","0","0","0","0","0","0","0","0","0","0","0","0","0","0","0","0","0","0","0","0","0","0"],
    ["0","0","0","0","0","0","0","0","0","0","0","0","0","0","0","0","0","0","0","0","0","0","0","0","0","0"],
    ["0","0","0","0","0","0","0","0","0","0","0","0","0","0","0","0","0","0","0","0","0","0","0","0","0","0"],
    ["0","0","0","0","0","0","0","0","0","0","0","0","0","0","0","0","0","0","0","0","0","0","0","0","0","0"],
    ["0","0","0","0","0","0","0","0","0","0","0","0","0","0","0","0","0","0","0","0","0","0","0","0","0","0"],
    ["0","0","0","0","0","0","0","0","0","0","0","x","0","0","0","0","0","0","0","0","0","0","0","0","0","0"],
    ["0","0","0","0","0","0","0","0","0","0","0","x","0","0","0","0","0","0","0","0","0","0","0","0","0","0"],
    ["0","0","0","0","0","0","0","0","0","0","0","x","0","0","0","0","0","0","0","0","0","0","0","0","0","0"],
    ["0","0","0","0","0","0","0","0","0","0","0","x","x","x","0","0","0","0","0","0","0","0","0","0","0","0"],
    ["0","0","0","0","0","0","0","0","0","0","0","0","0","0","0","0","0","0","0","0","0","0","0","0","0","0"],
    ["0","0","0","0","0","0","0","0","0","0","0","0","0","0","0","0","0","0","0","0","0","0","0","0","0","0"],
    ["RIGHT"]
  ],
  "room2": [
    ["0","0","0","0","0","0","0","0","0","0","0","0","0","0","0","0","0","0","0","0","0","0","0","0","0","0"],
    ["0","0","0","0","0","0","0","0","0","0","0","0","0","0","0","0","0","0","0","0","0","0","0","0","0","0"],
    ["0","0","0","0","0","0","0","0","0","0","0","0","0","0","0","0","0","0","0","0","0","0","0","0","0","0"],
    ["0","0","0","0","0","0","0","0","0","0","0","0","0","0","0","0","0","0","0","0","0","0","0","0","0","0"],
    ["0","0","0","0","0","0","0","0","0","0","0","0","0","0","0","0","0","0","0","0","0","0","0","0","0","0"],
    ["0","0","0","0","0","0","0","0","0","0","0","0","0","0","0","0","0","0","0","0","0","0","0","0","0","0"],
    ["0","0","0","0","0","0","0","0","0","0","0","0","0","0","0","0","0","0","0","0","0","0","0","0","0","0"],
    ["0","0","0","0","0","0","0","0","0","0","0","0","0","0","0","0","0","0","0","0","0","0","0","0","0","0"],
    ["0","0","0","0","0","0","0","0","0","0","0","0","0","0","0","0","0","0","0","0","0","0","0","0","0","0"],
    ["0","0","0","0","0","0","0","0","0","0","0","0","0","0","0","0","0","0","0","0","0","0","0","0","0","0"],
    ["0","0","0","0","0","0","0","0","0","0","0","0","0","0","0","0","0","0","0","0","0","0","0","0","0","0"],
    ["0","0","0","0","0","0","0","0","0","0","0","0","0","0","0","0","0","0","0","0","0","0","0","0","0","0"],
    ["0","0","0","0","0","0","0","0","0","0","0","0","0","0","0","0","0","0","0","0","0","0","0","0","0","0"],
    ["0","0","0","0","0","0","0","0","0","0","0","0","0","0","0","0","0","0","0","0","0","0","0","0","0","0"],
    ["0","0","0","0","0","0","0","0","0","0","0","0","0","0","0","0","0","0","0","0","0","0","0","0","0","0"],
    ["0","0","0","0","0","0","0","0","0","0","0","0","0","0","0","0","0","0","0","0","0","0","0","0","0","0"],
    ["DOWN", "LEFT", "UP", "RIGHT"]
  ]
}